MMMMMMMMMMMMMMMMMMMMMMMMMMMMMMMMMMMMMMMMMMMMMMMMMMMMMMMMMMMMMMMMMMMMMMMMMMMMMMMM
M                                                                              M
M                                                                              M
M                                                                              M
M                                                                              M
M                                                                              M
M                                                                              M
M                                                                              M
M                                                                              M
M                                                                              M
M                                                                              M
M                                                   MMMMMMMMMMM                M
M                                                   MMMMMMMMMMM                M
M                                                                              M
M      X                         MMMMMMMMMMM                                   O
M                                MMMMMMMMMMM                                   O
M                                                                              O
M             MMMMMMMMMMM                                                      O
M             MMMMMMMMMMM                                                      O
MMMMMMMMMMMMMMMMMMMMMMMMMMMMMMMMMMMMMMMMMMMMMMMMMMMMMMMMMMMMMMMMMMMMMMMMMMMMMMMM